...............................#.....................................................
...............................#.....................................................
..P............................#.........................................####........
...............................#...........................#.........................
.............#...........#................#..........................................
...............................................#.........#.........###...##..........
..........#.......#...................#............##....#.........#.................
......................................#............................#.................
......#..............#............#.......#........................#.................
............#...............###....................................#.................
.......,....#..............##......................................#.................
############...............#......................................##.................


