NAME: Start Area
WIDTH: 20
HEIGHT: 15

############################################
#..........................................#
#..........................................#
#....#.....................................#
#..........#.......#.......#.......#.......#
#.....P....#.......#.......#.......#.......#
############....####.......#################


